WWWWWWWWWWWWWWW
WWEEWEEEEEEEEWW
WEEWEEWWWWWWEEW
WEWWEWWWEEWEWEW
WEWEEWEEEWEEWEW
WEWEWWWTWWEWEEW
WEEEEEWEWWEWEWW
WWWWWEEMENEWEEW
WEEEEEWEWWEWWEW
WEWEGOWPEWWWEEW
WEWWWWWWEEWEEWW
WEEEEWWWWWEEWEW
WWWWEEEEEEEWWEW
WEEEEWWWWWEEEEW
WWWWWWWWWWWWWWW
