WWWWWWWWWWWWWWW
WWEEWEEEEEEEEWW
WEEWEEWWWWWWEEW
WEWWEWWWEEWEWEW
WEWEEWEEEWEEWEW
WEWEWWW1WWEWEEW
WEEEEEWEWWEWEWW
WWWWWEEME2EWEEW
WEEEEEWEWWEWWEW
WEWEGOW3EWWWEEW
WEWWWWWWEEWEEWW
WEEEEWWWWWEEWEW
WWWWEEEEEEEWWEW
WEEEEWWWWWEEEEW
WWWWWWWWWWWWWWW
