WWWWWWWWWWWWWWW
WWEEWEEEEEEEEWW
WEEWEEWWWWWWEEW
WEWWEWWWEEWEWEW
WEWEEWEEEWEEWEW
WEWEWWWEWWEWEEW
WEEEEEWEWWEWEWW
WWWWWEEMEEEWEEW
WEEEWWWEWWEWWEW
WEWEGOWEEWWWEEW
WEWWWWEWEEWEEWW
WEEEEWEEWWEEWEW
WWWWEWWEEEEWWEW
WEEEEEEEWWEEEEW
WWWWWWWWWWWWWWW
