WWWWWWWWWWWWWWW
WWEEWEEEEEEEEWW
WEEWEEWWWWWWEEW
WEWWEWWWEEWEWEW
WEWEEWEEEWEEWEW
WEWEWWWEWWEWEEW
WEEEEEWEWWEWEWW
WWWWWEEMEEEWEEW
WEEEWEEEWWEWWEW
WEWEGOWEEWWWEEW
WEWWWWEEEEWEEWW
WEEEEWEEWWEEWEW
WWWWEWWEEEEWWEW
WEEEEEEEWWEEEEW
WWWWWWWWWWWWWWW
