WWWWWWWWWWWWWWW
WWEEWEEEEEEEEWW
WEEWEEWWWWWWEEW
WEWWEWWWEEWEWEW
WEWEEWEEEWEEWEW
WEWEWWWEWWEWEEW
WEEEEEWEWWEWEWW
WWWWWEEMEEEWEEW
WEEEWWWEWWEWWEW
WEWEGOWEEWWWEEW
WEWWWWWWEEWEEWW
WEEEEWWWWWEEWEW
WWWWEEEEEEEWWEW
WEEEEWWWWWEEEEW
WWWWWWWWWWWWWWW
