{ 
    "level_": [
        "WWWWWWWWWWWWWWW",
        "WWWWWWWWWWWWWWW",
        "WWWWWWWWWWWWWWW",
        "WWWWWWWWWWWWWWW",
        "WWWWWWWWWWWWWWW",
        "WWWWWWWWWWWWWWW",
        "WWWWWWWWWWWWWWW",
        "WWWWEEEMEWWWWWW",
        "WWWWEEEEEWWWWWW",
        "WEWEGOWEEWWWWWW",
        "WWWWWWWWWWWWWWW",
        "WWWWWWWWWWWWWWW",
        "WWWWWWWWWWWWWWW",
        "WWWWWWWWWWWWWWW",
        "WWWWWWWWWWWWWWW"
    ]
}
