{ 
    "level_": [
        "WWWWWWWWWWWWWWW",
        "WWEEWEEEEEEEEWW",
        "WEEWEEWWWWWWEEW",
        "WEWWEWWWEEWEWEW",
        "WEWEEWEEEWEEWEW",
        "WEWEWWWEWWEWEEW",
        "WEEEEEWEWWEWEWW",
        "WWWWWEEMEEEWEEW",
        "WEEEEWWEWWEEWEW",
        "WEWEGOWEEWWWEEW",
        "WEWWWWEEEEWEEWW",
        "WEEEEWEWWWEEWEW",
        "WWWWEWWEEEEWWEW",
        "WEEEEEEEWWEEEEW",
        "WWWWWWWWWWWWWWW"
    ]
}
