{ 
    "level_frame": [
        "WWEEWWEEEEEEEWE",
        "EWEWEEEWEWEWEEE",
        "EEEEWEWWWEEWWEW",
        "EWWEWEWEEEWWEEE",
        "EEWEWWEEWWEWEWE",
        "WEWEEEWEWEEEWEE",
        "WEEWWEEWEWWEWEW",
        "OGEEEWWWEEWEEEM",
        "WWEWEEEEWEEWEWW",
        "EEEWEWWEWWEWEEE",
        "EWWEEWEWEEEEWWE",
        "EEWEWEEWWEWEWEE",
        "EWEEEEWEWWEEEEW",
        "EWEWEWEEEEWEWEW",
        "EEWEEEEWWEEEWEW"
    ]
}